###############
#111111#222222#
#111111#222222#
#111111D222222#
#111111#222222#
#111111#222222#
###############