###############
#------#------#
#------#------#
#------D------#
#------#------#
#------#------#
###############